34 20 20 20 20 20 20 20 20 20 20 20 20 20 20 36
16 0 0 4 8 0 0 4 8 0 0 0 0 0 0 24
16 0 0 24 16 0 0 24 16 0 0 0 0 0 0 24
16 0 0 24 16 0 0 24 16 0 0 0 0 0 0 24
16 0 0 24 16 0 0 24 16 0 0 0 0 0 0 24
16 0 0 24 16 0 0 24 16 0 0 0 0 0 0 24
16 0 0 24 16 0 0 24 16 0 0 0 0 0 0 24
16 0 0 24 16 0 0 24 16 0 0 0 0 0 0 24
16 0 0 24 16 0 0 24 16 0 0 0 0 0 0 24
16 0 0 24 16 0 0 24 16 0 0 0 0 0 0 24
16 0 0 2 1 0 0 2 1 0 0 0 0 0 0 24
40 28 28 28 28 28 28 28 28 28 28 28 28 28 28 38
