34 20 20 20 20 20 20 20 20 20 20 20 20 20 20 36
16 0 0 0 8 0 0 4 0 0 0 0 0 0 0 24
16 0 0 0 16 0 0 24 0 0 0 0 0 0 0 24
16 0 0 0 16 0 0 24 0 0 0 0 0 0 0 24
16 0 0 0 16 0 0 24 0 0 0 0 0 0 0 24
16 0 0 0 16 0 0 24 0 0 0 0 0 0 0 24
16 0 0 0 16 0 0 24 0 0 0 0 0 0 0 24
16 0 0 0 16 0 0 24 0 0 0 0 0 0 0 24
16 0 0 0 16 0 0 24 0 0 0 0 0 0 0 24
16 0 0 0 16 0 0 24 0 0 0 0 0 0 0 24
16 0 0 0 1 0 0 2 0 0 0 0 0 0 0 24
40 28 28 28 28 28 28 28 28 28 28 28 28 28 28 38
